. . . . . . .
. . # . . # .
. # . . . . .
. # . . . # .
. # # # # . .
. . . . . . .
