. . . . . . . .
. . . . . . . .
. . . # # # . .
. . # # # . . .
. . . . . . . .
. . . . . . . .
